converterClass	com.equalize.xpi.af.modules.deepfcc.DeepPlain2XMLConverter
documentName	MT_DeepPlain2XML
documentNamespace	urn:equalize:com
recordsetStructure	Header,Delivery,Order,OrderText,Item,Footer
keyFieldName	Type
Header.fieldNames	Type,FileName
Delivery.fieldNames	Type,DeliveryNo
Order.fieldNames	Type,DeliveryNo,OrderNo
OrderText.fieldNames	Type,OrderNo,TextValue
Item.fieldNames	Type,OrderNo,ItemNo,Quantity
Footer.fieldNames	Type,DeliveryCount
Header.keyFieldValue	H
Delivery.keyFieldValue	D
Order.keyFieldValue	O
OrderText.keyFieldValue	T
Item.keyFieldValue	I
Footer.keyFieldValue	F
Header.parent	Root
Delivery.parent	Root
Order.parent	Delivery
OrderText.parent	Order
Item.parent	Order
Footer.parent	Root
defaultFieldSeparator	,
indentFactor	2
messageLog	pre
logLocation	plain
