converterClass	com.equalize.xpi.af.modules.deepfcc.DeepPlain2XMLConverter
documentName	MT_DeepPlain2XML
documentNamespace	urn:equalize:com
recordsetStructure	Delivery,Order,Item
keyFieldName	Type
Delivery.fieldNames	Type,DeliveryNo
Order.fieldNames	Type,DeliveryNo,OrderNo
Item.fieldNames	Type,OrderNo,ItemNo,Quantity
Delivery.keyFieldValue	D
Order.keyFieldValue	O
Item.keyFieldValue	I
Delivery.parent	Root
Order.parent	Delivery
Item.parent	Order
Delivery.fieldSeparator	'0x09'
defaultFieldSeparator	,
Order.enclosureSignBegin	"
Order.enclosureSignBeginEscape	""
//Order.enclosureSignEnd	"
//Order.enclosureSignEndEscape	""
Item.enclosureConversion	N
Item.enclosureSignBegin	"
rowOffset	1
indentFactor	2
