converterClass	com.equalize.xpi.af.modules.deepfcc.DeepPlain2XMLConverter
documentName	MT_DeepPlain2XML
documentNamespace	urn:equalize:com
recordsetStructure	Header,Delivery,Order,Item
keyFieldName	Type
Header.fieldNames	Type,FileName
Delivery.fieldNames	Type,DeliveryNo
Order.fieldNames	Type,DeliveryNo
Item.fieldNames	Type,OrderNo
Header.keyFieldValue	CR
Delivery.keyFieldValue	DH
Order.keyFieldValue	DD
Item.keyFieldValue	TR
Header.parent	Root
Delivery.parent	Root
Order.parent	Delivery
Item.parent	Root
Header.fieldFixedLengths	2,15
Delivery.fieldFixedLengths	2,15
Order.fieldFixedLengths	2,15
Item.fieldFixedLengths	2,15
trimContents	N
indentFactor	2
